0,0,0,0,0,0
0,0,0,0,0,0
0,0,0,2,0,3
2,1,0,4,2,1
1,3,3,1,3,2
