0,0,0,0,0,0,0
0,0,0,0,0,0,0
2,0,4,0,0,0,1
3,0,3,1,5,0,1
5,2,3,4,2,4,5
