6,17,0,0,18,5,0,0
5,12,18,8,6,16,15,17
10,9,7,7,12,1,9,10
3,2,2,4,15,14,16,4
3,13,8,13,1,11,14,11
