0,9,2,0,2,0,1,7
0,9,4,5,3,6,2,5
9,3,5,7,6,7,6,8
1,3,5,3,7,6,8,4
1,2,9,1,8,4,4,8
