12,1,9,0,0,0,5,0
3,18,13,12,4,8,16,2
10,6,2,17,14,8,6,5
16,7,11,17,3,9,14,13
4,7,10,15,18,11,1,15
