6,7,2,0,0
5,3,6,0,0
2,3,4,2,5
1,4,7,7,3
1,4,1,6,5
