0,0,0,0,0,0
0,0,0,0,0,0
0,0,2,2,0,0
0,3,1,2,3,1
1,3,4,1,3,2
