0,0,0,0,0,0,0,0
0,0,5,1,0,0,7,0
0,0,8,4,0,0,2,0
0,0,1,4,0,8,2,0
9,3,9,6,3,7,5,6
