0,6,0,0,14,8,0,1
3,16,7,15,5,17,4,2
17,15,18,4,18,11,6,3
10,13,2,11,13,5,12,7
8,14,9,10,9,16,12,1
