6,9,0,0,5,0
3,5,8,2,7,0
1,6,3,8,3,4
9,7,1,4,5,7
2,2,4,8,1,6
