0,0,0,0,0,0,0,0,0
0,0,0,0,0,0,0,0,0
2,4,0,0,0,5,3,0,0
5,5,1,3,0,1,2,0,3
4,1,3,2,1,5,4,2,4
