0,0,0,0,0,0
0,0,0,0,0,0
0,0,3,5,0,0
1,3,1,2,2,0
3,2,1,4,4,4
