6,0,0,0,1,2
3,3,0,2,3,4
5,4,2,5,5,3
6,7,1,1,5,4
2,4,1,7,6,6
