0,1,0,0,3
0,7,7,6,4
2,3,5,2,6
1,7,6,5,5
2,4,1,4,3
