0,0,0,0,0,0,0,0
0,0,0,0,0,0,0,1
0,4,0,0,0,4,1,2
0,3,0,3,0,5,2,1
1,5,2,4,2,4,3,3
