1,14,9,7,0,0,0,9,0
7,6,12,2,13,5,4,4,8
10,7,1,4,11,1,12,5,9
13,14,6,5,10,8,2,12,2
3,10,8,11,13,6,3,11,3
