0,0,5,0,11,11,0,3
10,7,2,10,9,1,7,7
5,12,2,12,11,4,12,3
9,8,1,8,2,9,4,10
5,6,3,8,6,6,4,1
