0,5,0,0,0,0,0,0,0
0,1,0,0,0,0,0,0,0
0,3,0,3,0,0,0,0,3
4,3,0,2,2,0,1,0,5
4,5,2,4,2,1,5,1,4
