0,0,5,3,0
1,0,3,3,2
5,2,5,1,4
2,4,3,4,1
5,6,1,4,2
