9,0,8,1,6,7,0,4,0
1,0,10,10,4,2,5,4,7
11,7,8,8,9,4,6,5,5
9,2,1,3,10,10,3,7,6
2,3,5,3,6,1,8,9,2
