0,0,0,0,0
0,0,0,0,0
2,1,0,0,3
4,3,0,0,5
5,4,2,0,1
