0,3,0,3,6,3,1,0
9,5,0,8,4,5,8,7
5,7,6,6,6,2,4,9
4,7,8,9,2,2,8,5
4,1,1,3,1,7,2,9
