0,0,0,0,0,0
0,0,0,0,0,0
3,2,0,0,3,0
4,2,0,0,1,1
1,3,2,2,1,3
