0,0,0,0,0,0,0,0
0,0,6,0,0,0,0,0
0,0,7,8,0,0,0,9
5,9,1,2,2,1,0,4
3,8,3,4,7,5,0,6
