3,7,7,0,0,8
8,9,1,0,0,6
3,3,4,9,5,7
6,5,4,6,5,2
4,2,2,1,8,1
