0,0,0,0,0,0,0,0,0
0,0,2,0,0,0,0,0,0
0,4,1,0,5,0,0,0,0
3,1,3,4,1,3,0,5,5
2,1,3,2,2,4,0,5,4
