3,0,0,0,0,0,0,0,0
3,0,0,0,0,0,0,0,0
4,1,0,0,1,0,0,0,0
7,6,0,5,4,6,0,0,2
5,2,6,7,2,1,4,3,5
