0,9,8,0,2,0,6,0
6,9,1,7,1,7,4,1
4,2,6,5,8,3,8,5
3,1,3,2,5,8,9,7
5,6,9,4,2,7,3,4
