0,0,0,0,0,0,0,0
0,0,0,0,0,0,0,0
0,2,0,0,3,0,0,0
1,6,4,2,4,1,5,3
4,5,6,6,2,3,1,5
