3,0,5,2,0,7,0,0
8,4,8,2,4,1,9,1
1,6,5,8,7,9,6,9
2,7,5,1,8,2,9,3
7,6,6,3,5,3,4,4
