0,5,0,16,10,8,1,0,0
15,11,17,7,13,19,21,4,16
12,20,15,18,19,2,1,8,17
14,3,5,6,9,12,4,7,10
20,14,13,2,9,18,3,6,11
