0,4,5,0,6,3
0,2,7,1,4,3
0,4,3,7,2,2
5,6,6,4,1,5
3,1,5,6,1,2
