0,0,0,0,0,0,5,0,0
0,0,0,0,0,0,2,0,0
0,0,0,0,0,0,5,0,1
4,0,0,4,5,1,3,4,2
3,2,2,4,3,5,1,1,3
