4,0,0,6,2
2,0,0,6,7
7,7,3,3,1
3,5,1,5,1
5,4,6,4,2
