0,0,5,0,11,4,0,10
15,17,17,9,13,6,4,7
8,8,2,16,1,5,1,18
14,3,13,12,16,6,7,15
11,10,18,9,2,3,12,14
