0,0,6,0,0,4,4,5
12,7,8,3,1,6,9,9
7,8,4,7,2,5,11,11
6,5,3,10,12,10,9,10
12,2,3,2,8,1,1,11
