0,0,0,0,0,0,0,0,0
0,0,0,0,0,0,0,0,0
0,0,7,4,0,0,0,1,2
9,0,2,8,10,0,6,5,5
9,8,4,10,3,7,3,1,6
