0,0,0,0,0
0,0,0,0,0
0,0,0,3,0
0,1,1,2,2
1,4,3,2,3
