0,0,0,0,0,0
0,0,0,0,4,0
0,0,4,0,1,0
0,1,1,0,2,4
5,2,3,2,3,3
