2,0,0,6,2,3,0,4
7,0,6,7,3,4,8,1
1,9,3,5,1,4,5,9
9,9,7,6,3,5,5,1
4,8,7,2,8,6,2,8
