0,0,0,0,0
0,0,0,0,0
0,0,4,0,0
1,1,3,2,0
4,5,3,2,5
