0,0,0,0,0,0,0
2,0,0,0,0,0,0
2,3,0,0,0,0,0
6,6,8,0,7,0,1
4,5,3,5,1,4,7
