0,0,0,0,0
0,0,0,0,0
0,0,2,0,0
3,1,4,0,2
1,3,1,2,3
