0,0,1,4,14,9,0,13
16,5,10,9,5,18,0,2
12,11,12,15,6,8,18,16
13,4,3,2,17,6,1,15
7,10,7,3,11,8,14,17
