0,0,0,0,0
0,0,0,0,0
0,0,1,0,0
5,2,5,0,4
2,4,3,3,1
