0,0,0,0,0
0,0,0,0,0
2,0,0,0,0
1,4,0,3,1
1,2,2,3,3
