3,5,0,0,5,0,9,6,0
1,7,1,9,10,9,8,8,3
4,8,10,1,10,11,2,8,3
9,4,5,6,6,2,2,4,10
7,1,2,7,3,5,7,4,6
