0,14,10,7,9,4,0,0
0,14,6,11,16,3,8,12
18,5,15,5,10,6,7,18
13,2,13,15,11,17,16,12
3,1,4,17,9,1,8,2
