0,0,0,0,0,0,0,0
0,0,0,0,0,0,0,0
0,0,0,0,0,4,1,4
5,0,2,3,3,3,5,1
1,2,2,4,2,3,4,1
