0,0,0,0,0,0
0,0,0,0,0,0
0,0,3,0,1,2
3,0,2,0,2,1
1,4,1,3,3,2
