0,0,0,0,0,0
0,0,0,0,0,0
0,0,0,3,1,0
4,0,4,3,5,1
3,2,2,4,2,1
