0,0,7,4,0,0
2,1,5,1,4,3
3,8,8,2,4,2
9,6,3,1,5,7
9,6,7,5,8,6
