0,0,0,0,0
0,0,0,0,0
0,0,2,0,2
0,3,2,0,1
2,3,1,1,1
