0,0,0,0,0,0,0
0,0,0,0,0,0,0
0,2,0,0,1,1,0
0,4,4,0,5,4,5
1,2,5,3,3,2,3
