0,0,6,0,4,1
5,0,3,2,7,5
7,4,4,3,6,1
4,6,5,5,2,3
6,1,2,1,3,2
