0,0,0,0,0,0,0,0,0
0,0,0,4,0,5,0,0,0
1,0,0,2,0,1,0,0,5
4,0,0,2,0,3,4,0,3
5,2,4,3,1,2,3,5,1
