0,0,0,0,0
0,0,0,0,0
0,3,0,0,4
2,1,0,3,1
2,3,0,2,1
