0,0,0,0,0,0
0,0,0,0,0,1
3,0,0,0,0,1
3,0,2,2,0,1
4,2,2,1,3,3
