3,0,6,0,7,4,0
6,0,7,1,3,1,2
4,8,2,7,2,6,3
6,4,8,3,1,5,5
4,5,5,8,7,1,2
