0,0,0,0,0,0
0,0,0,0,6,0
0,0,7,2,1,0
0,0,3,4,5,6
0,3,1,4,2,5
