0,0,0,0,0,0,0,0
0,0,0,0,0,0,0,2
3,4,0,0,0,0,0,1
3,4,0,0,5,2,1,3
2,1,4,1,3,5,2,4
