0,0,0,0,0,0,0,0,0
0,0,0,4,0,0,0,0,0
0,0,0,6,4,0,4,2,0
0,0,1,7,2,3,1,7,0
5,5,6,2,3,6,5,3,1
