0,0,5,3,7,0,0,4
8,6,9,7,1,8,6,9
2,2,4,5,7,6,5,7
4,1,8,3,9,4,2,8
3,1,9,1,5,2,3,6
