0,0,0,11,5,19,6,0,17
7,7,14,17,12,15,5,21,9
11,3,13,15,12,20,9,1,10
4,14,6,10,18,2,8,19,13
20,16,3,18,8,4,16,1,2
