0,11,0,0,20,7,0,3,7
10,19,9,1,4,16,5,13,14
18,15,2,10,1,13,18,8,3
20,12,16,4,19,21,11,9,5
2,12,6,15,14,8,17,6,17
