1,0,0,0,3
1,0,5,2,6
5,3,3,5,4
4,4,2,3,2
5,1,1,2,4
