0,19,0,0,4,10,18,0,6
18,3,1,17,17,7,7,2,8
12,14,5,9,4,21,1,10,9
20,14,11,3,13,11,19,13,16
15,15,5,16,2,8,6,12,20
