0,0,2,0,1
4,0,5,4,1
4,1,4,6,5
2,3,3,5,2
2,5,3,3,1
