0,0,0,0,0,0,0,0,0
0,0,0,0,1,0,0,0,0
0,1,0,4,4,0,0,0,9
8,9,5,2,6,0,0,0,5
7,10,3,2,7,8,10,6,3
