0,0,8,0,8,4,11,2
10,0,3,7,7,4,12,5
10,2,9,4,9,3,10,2
1,8,5,5,11,1,11,12
6,6,9,6,7,12,1,3
