14,4,4,6,11,0,0,0,0
1,10,9,2,2,10,9,6,7
10,14,11,6,3,4,8,8,5
5,13,12,3,2,12,13,11,12
3,1,7,8,1,9,7,13,5
