0,2,0,1,4,0
0,7,8,9,5,4
1,4,9,2,1,5
3,2,3,8,6,7
7,3,6,5,6,8
