0,0,0,0,4,3
5,1,6,6,6,2
7,1,4,1,6,7
4,4,1,3,2,3
5,5,3,2,5,2
