0,0,0,0,4,3
2,5,1,6,1,3
1,9,5,3,4,5
7,8,7,8,2,9
6,6,4,7,2,8
