0,0,0,0,0,0,0,0,0
7,0,0,0,0,0,0,0,0
1,2,3,0,0,0,0,0,0
3,1,4,0,6,2,4,0,6
3,5,4,5,7,1,2,5,6
