4,8,0,10,0,0,6,2,12
6,11,5,2,0,14,7,20,12
11,4,1,17,9,21,13,1,5
16,16,18,7,9,14,19,13,3
17,8,3,20,10,15,18,15,19
