0,1,0,0,5,0
3,8,9,7,6,3
6,2,8,3,8,7
1,4,4,5,2,6
1,2,9,5,7,4
