0,0,7,4,0,6,5,8,0
10,2,8,3,1,8,6,6,9
4,4,2,7,2,5,6,1,10
3,7,1,9,11,5,9,7,8
4,10,3,2,9,10,1,5,3
