0,0,0,0,0,0,0,0,0
0,0,0,3,0,0,0,0,0
6,0,0,1,0,1,0,3,0
4,0,4,5,2,2,3,2,0
5,1,6,7,7,6,5,4,0
