4,0,0,3,1
1,0,0,2,5
5,2,2,6,4
5,5,4,1,3
4,1,3,3,2
