0,0,0,0,0,0,0,0
6,0,0,0,0,0,0,0
8,0,0,0,0,2,0,0
6,4,1,7,3,5,5,0
4,9,7,2,1,8,9,3
