0,0,0,0,0,0,0
0,0,0,0,0,0,0
2,0,0,1,0,0,3
2,4,0,3,1,0,4
2,3,2,3,1,1,4
