6,0,0,0,4
7,7,4,0,3
1,6,3,7,2
2,2,1,4,5
5,3,6,1,5
