0,0,0,0,0
0,0,0,0,0
0,2,0,0,0
3,1,4,0,2
4,5,1,3,5
