0,20,19,13,0,3,4,14,0
0,17,7,7,5,6,9,18,17
11,18,2,15,10,10,3,5,2
6,12,4,8,14,1,12,8,1
21,9,16,13,16,11,15,19,20
