0,0,0,0,0,0
0,4,0,0,0,0
0,1,0,0,0,4
2,3,3,0,0,1
3,1,2,4,5,2
