7,0,0,2,8,5,11,4,0
4,0,6,5,6,7,9,3,4
2,10,8,9,10,1,4,1,9
7,6,1,8,3,8,6,10,7
1,3,10,5,9,3,2,2,5
