0,0,0,0,0,0
0,0,0,0,0,4
1,0,0,0,0,3
3,0,0,2,2,1
1,3,3,2,2,1
