0,0,0,0,0,0,0
0,0,0,0,0,0,5
0,0,0,0,0,0,3
6,0,2,8,6,3,4
1,2,7,1,5,7,4
