0,4,3,0,0,0
7,2,1,3,5,6
6,4,1,5,2,3
5,3,1,4,6,2
6,1,5,7,4,2
