0,0,0,0,0
0,0,0,0,0
0,0,4,3,0
0,0,1,2,2
3,5,4,5,1
