0,0,14,7,0,13,8,1
11,0,14,4,11,18,6,12
9,16,12,3,9,13,15,8
4,2,1,17,5,7,16,18
17,10,10,3,15,5,2,6
