0,0,0,0,0,0,0,0,0
0,0,4,0,0,0,0,0,0
1,0,3,0,1,0,0,4,3
2,5,6,0,5,0,0,2,6
4,6,2,0,5,7,7,3,1
