0,0,0,0,0,0,0,0,0
0,0,0,0,0,0,0,0,2
0,4,0,0,0,0,5,0,1
3,3,3,0,5,3,1,2,5
5,4,4,0,2,1,4,2,1
