0,0,0,0,0,0
0,0,0,0,0,0
0,0,3,3,0,0
3,0,2,1,2,1
4,3,2,1,1,2
