0,3,0,1,0
5,6,0,2,3
4,3,4,5,1
5,5,3,2,1
4,1,2,2,4
