0,4,0,3,0
3,1,4,5,0
5,6,5,4,4
2,3,2,1,2
1,2,1,5,3
