0,0,0,0,0,0,0,0
0,0,0,0,0,0,0,0
0,1,0,0,0,5,0,2
3,6,0,6,5,4,2,4
6,2,1,4,3,5,1,3
