0,0,0,0,0,0,0,0
0,0,0,0,0,0,0,0
2,0,0,1,2,0,0,0
3,9,3,8,8,5,9,0
7,4,6,5,6,1,7,4
