2,8,4,1,3,0,8,0
2,9,1,5,5,5,3,0
6,4,7,3,6,1,9,0
5,3,2,1,7,7,6,6
2,9,7,8,4,4,9,8
