0,0,0,0,0,0,0
0,0,0,0,0,0,0
0,0,0,0,0,0,4
7,5,7,1,1,6,3
4,2,3,6,5,8,2
