0,0,0,0,0,0,0,0
0,0,0,0,0,0,0,0
5,0,1,0,1,0,0,0
4,3,4,3,3,3,0,2
1,5,4,2,2,2,4,1
