0,0,0,0,0,0,0,0,0
0,4,0,0,0,0,0,0,0
3,4,0,1,0,0,0,0,0
1,2,5,1,0,5,5,0,4
5,3,2,3,3,1,2,2,4
