0,0,0,0,0,0,0
0,0,0,0,0,0,4
0,0,4,0,0,0,4
3,0,3,5,5,0,5
2,3,1,1,2,1,2
