2,0,3,0,0
5,2,1,3,0
6,3,2,4,1
1,4,2,5,4
5,1,4,5,3
