6,0,0,2,3,1
5,4,0,7,3,1
2,6,0,1,4,2
3,2,5,5,4,1
3,6,7,4,6,5
