0,0,9,3,8,0,11,2,10
9,13,13,14,12,0,3,11,4
12,7,11,6,8,6,4,5,6
9,5,14,8,10,10,4,7,1
2,1,3,7,12,13,1,5,2
