0,0,0,0,0,0,0,0
0,0,0,0,0,0,0,0
3,0,9,3,0,0,0,0
4,0,6,2,8,1,5,7
4,2,1,8,9,5,6,7
