0,0,0,0,0,0
0,0,0,0,0,0
2,0,0,0,2,1
4,1,0,0,1,3
3,2,3,3,2,1
