6,0,0,0,0,0,0,0
9,0,0,0,0,0,0,0
5,3,8,0,0,0,0,0
7,4,1,3,0,0,0,8
5,4,2,6,9,1,2,7
