0,0,0,0,0,0,0,0
0,0,0,0,0,0,0,0
0,0,0,5,2,9,4,0
8,0,0,5,2,1,3,6
4,3,6,7,7,8,9,1
