0,7,10,0,3,0,0,9
2,5,5,1,9,2,1,10
11,12,8,6,4,3,6,8
4,11,10,1,11,3,5,6
8,9,7,12,4,2,12,7
