0,0,0,0,0,0,0,0,0
0,0,1,0,0,0,0,0,0
0,2,3,4,0,0,1,5,0
0,2,4,4,0,0,5,3,0
2,5,5,1,3,2,1,4,3
