0,0,0,0,0,0,0
0,1,0,0,0,0,0
0,3,7,0,0,0,0
0,1,2,0,5,5,7
4,6,2,8,4,3,6
