0,0,0,0,0,0,0,0
4,0,0,0,0,1,3,0
4,0,0,0,0,2,3,0
4,0,0,0,1,3,1,0
5,2,3,2,4,1,2,5
