0,0,0,0,0,0,0,0,0
0,6,0,0,0,2,0,0,0
0,1,0,0,0,2,0,0,0
5,4,0,0,1,3,7,3,1
6,7,5,6,4,3,5,4,2
