0,0,0,0,0,0,0,0,0
0,0,0,0,0,0,0,0,0
0,0,9,2,0,0,5,6,0
8,4,10,7,4,0,6,3,7
9,3,2,1,10,0,1,5,8
