8,0,4,9,9,0,0,0,1
6,3,2,10,10,4,6,3,6
9,8,8,8,10,9,7,11,7
2,5,1,2,5,7,2,1,3
1,3,5,5,7,6,10,4,4
