4,0,1,0,0
4,1,5,2,0
2,5,5,3,3
5,3,4,3,6
2,2,1,1,4
