0,0,0,0,0,0,0,0,0
2,0,0,0,0,3,0,0,0
1,6,0,0,0,8,0,0,7
5,10,0,4,0,10,0,4,1
2,8,0,9,6,9,5,7,3
