0,1,0,6,0,5,7,8,0
6,5,10,6,2,2,7,3,2
5,3,7,9,1,3,6,4,2
9,10,11,3,4,4,8,9,10
5,9,8,10,1,1,8,4,7
