0,0,0,3,0
4,7,1,6,5
2,5,2,5,7
4,6,3,7,1
2,3,6,1,4
