2,0,0,6,0,12,0,12
4,12,5,8,4,1,11,3
1,9,9,8,6,11,8,7
10,9,11,5,7,2,4,3
5,6,3,10,7,10,1,2
