0,0,0,0,0,0,0
0,0,0,0,0,0,0
0,3,0,0,2,2,0
1,1,0,4,3,3,5
5,4,0,2,1,5,4
