0,0,0,0,0,0,0,0,0
0,0,9,0,0,0,0,0,0
0,9,8,0,4,0,2,0,0
0,3,8,10,3,0,2,0,1
7,5,10,1,7,6,6,5,4
