0,0,0,0,0,0,0
2,0,0,0,0,0,0
1,1,0,0,0,5,0
3,8,7,0,7,2,0
3,4,6,4,6,5,0
