0,0,0,0,0,0,0,0
0,0,0,0,0,0,0,0
0,1,0,6,3,0,3,0
3,2,4,5,6,0,4,0
6,1,4,5,2,2,5,1
