0,0,0,0,0,0,0,0
0,0,3,0,0,0,0,0
0,0,5,0,0,4,0,0
5,0,6,4,2,1,3,3
5,4,2,6,1,2,1,6
