0,0,0,0,0,0,0
0,0,0,0,0,0,0
0,0,1,0,3,0,0
3,0,2,5,4,5,3
2,5,1,2,4,1,4
