0,0,0,0,0,0,0,0,0
0,0,0,0,0,6,0,0,0
2,0,2,0,0,10,0,0,0
4,9,1,9,7,10,7,0,6
8,1,3,5,8,3,5,0,4
