0,0,0,0,0,0
0,0,0,0,0,0
0,0,0,3,0,6
5,5,4,3,0,7
1,6,1,2,4,2
