11,13,0,0,10,12,0,8,0
2,9,7,8,4,14,1,3,1
3,11,4,14,7,10,12,9,9
6,5,2,5,5,4,13,6,3
13,6,8,2,1,12,11,10,7
