0,7,9,0,0,2,3,0
7,2,5,8,6,10,12,3
12,8,6,4,10,3,1,9
5,11,11,10,1,6,9,12
1,11,2,4,7,5,4,8
