0,0,0,0,0,0
0,0,0,0,0,1
0,0,0,0,0,1
1,2,4,0,1,3
3,2,2,3,3,2
