0,0,0,0,0,0,0,0,0
1,0,0,0,0,0,2,3,0
2,5,0,0,0,0,5,4,1
4,4,0,0,0,0,3,1,5
2,4,3,0,0,1,3,5,2
