0,0,0,0,1,7,4,10,10
7,7,2,5,5,5,10,1,1
1,10,2,6,7,3,9,2,3
9,6,4,8,3,9,4,5,4
8,11,2,6,8,3,6,8,9
