0,0,0,0,0,0
0,0,0,0,4,0
0,0,0,2,4,0
0,3,0,3,1,1
1,3,4,2,5,2
