16,0,4,0,5,5,0,0
10,17,3,12,12,2,17,4
18,9,7,13,7,14,2,10
9,8,6,14,13,1,11,11
15,15,18,6,1,3,16,8
