3,0,0,5,0
5,5,0,2,1
1,1,7,6,7
4,4,6,3,3
7,6,4,2,2
