9,0,0,4,9,0,2,0
6,6,4,10,10,5,12,1
3,11,1,8,2,7,4,12
12,9,6,5,3,2,8,10
7,8,11,1,3,11,7,5
