0,0,0,0,0,0,0,0,0
0,0,0,0,0,7,0,0,0
5,0,1,4,0,2,0,0,0
2,0,4,2,0,5,0,5,6
1,6,3,4,6,7,3,1,3
