0,0,0,0,0
0,0,2,0,0
0,1,1,0,0
0,2,1,3,0
0,3,2,4,3
