0,0,0,0,0
0,0,0,0,0
0,0,1,0,0
4,3,3,0,2
2,3,1,1,2
