19,0,4,17,4,0,0,0,18
8,19,12,8,13,5,6,10,1
12,20,11,10,5,14,18,9,16
6,15,11,9,7,3,1,20,7
17,21,2,14,3,16,13,15,2
