0,1,4,7,0,9,0,4
9,2,8,8,0,6,7,3
3,5,6,2,7,1,9,6
8,2,4,5,3,2,1,1
5,4,8,7,9,6,5,3
