0,0,0,0,0,0
0,0,4,0,0,0
5,0,3,0,0,0
2,0,5,2,1,0
1,3,7,4,6,6
