0,0,0,0,0,0,0,0
0,0,0,0,0,0,0,4
0,0,6,0,1,0,0,2
3,5,2,3,1,0,0,1
5,5,3,6,6,4,2,4
