0,0,0,0,0,0,0,0,0
0,0,0,0,0,5,0,0,0
0,0,0,0,7,3,0,3,2
8,9,0,2,6,1,0,5,4
9,4,0,10,8,10,7,6,1
