0,0,7,4,3,1
2,0,8,6,5,7
1,0,1,3,8,3
4,6,2,9,2,9
7,6,8,5,4,5
