2,1,0,10,5,1,3,0,0
4,5,2,10,6,3,1,0,4
5,9,10,4,9,1,4,9,2
10,6,11,8,7,7,5,8,7
8,8,6,9,6,2,3,3,7
