0,0,0,0,0,0,0,0,0
0,0,0,2,0,0,0,0,0
2,3,0,1,0,0,0,0,3
1,5,3,5,4,0,2,0,5
4,1,3,5,2,1,4,0,4
