8,0,6,0,0,0,5,12
11,6,11,5,7,1,3,1
11,12,4,6,9,2,3,10
10,9,12,2,8,4,1,10
7,9,4,5,8,2,7,3
