0,0,0,0,0,0,0
0,0,0,0,0,0,0
3,0,1,0,5,0,0
3,4,4,0,5,1,0
2,5,2,1,4,2,3
