11,4,8,2,0,7,0,0,0
3,10,4,1,5,6,8,7,3
9,2,8,1,5,6,2,3,9
5,3,10,6,7,7,2,5,6
4,10,4,10,9,9,8,1,1
