0,0,0,0,0,0,0
0,0,0,1,0,0,0
0,0,0,3,0,0,0
2,4,0,1,5,3,3
4,5,4,2,2,1,5
