0,1,0,0,5
2,2,4,0,4
3,5,5,4,4
1,2,3,6,1
5,3,3,2,1
