0,0,0,0,0,0
0,0,0,0,0,0
0,0,3,2,0,0
0,3,1,2,3,3
2,1,1,4,2,1
