5,0,0,0,3,1
1,0,6,5,2,5
1,6,2,4,4,6
4,7,4,1,7,3
2,2,5,6,3,3
