0,0,0,0,0,0,0
0,0,0,0,0,0,0
0,0,2,1,0,0,0
7,2,7,3,0,6,3
5,5,4,8,6,4,1
