0,2,18,0,10,6,0,0
17,3,14,16,15,16,13,10
8,12,18,9,14,1,11,5
2,6,9,7,12,4,8,1
17,4,3,5,15,7,11,13
