1,0,10,0,11,18,2,0
13,12,4,1,14,11,3,0
5,6,17,17,3,15,4,6
12,2,7,15,16,8,13,16
9,14,9,10,18,5,7,8
