3,14,6,19,0,0,0,4,4
13,11,9,7,0,12,14,20,10
19,21,11,18,16,1,17,18,8
12,10,13,5,7,15,15,3,9
1,8,2,6,17,2,5,16,20
