0,0,4,0,7
2,5,1,0,5
1,7,1,3,6
2,4,4,7,6
3,6,5,2,3
