0,0,0,0,0
0,0,0,0,0
1,0,0,0,0
2,0,2,4,3
4,3,5,5,1
