0,0,0,0,0,0,0,0,0
7,0,0,0,0,0,0,0,0
8,0,0,0,4,6,0,0,0
2,0,0,4,5,9,7,3,2
1,8,9,10,6,1,10,5,3
