0,0,0,0,0,0
0,0,0,0,0,0
0,0,3,0,0,1
4,0,2,2,3,2
3,2,3,1,1,1
