0,0,0,0,0,0,0,0
0,0,0,0,0,0,0,0
0,0,6,0,0,9,0,8
7,1,3,6,0,5,2,8
4,3,4,9,7,2,1,5
