6,0,4,0,0,7
1,0,5,1,7,5
6,3,6,6,5,4
3,5,3,2,4,1
2,2,2,1,4,3
