0,0,0,0,0,0
0,0,0,0,0,0
0,0,0,2,0,1
1,3,1,3,0,2
2,4,2,3,3,1
