0,1,17,9,0,8,0,0
18,5,9,10,14,7,1,16
2,14,5,12,8,13,7,13
6,2,3,17,6,11,3,18
4,15,11,16,10,4,12,15
