0,7,20,0,6,0,4,0,9
20,16,17,2,14,11,2,3,12
18,14,12,7,16,15,21,17,3
1,1,4,6,11,10,19,13,9
8,19,10,5,18,5,15,13,8
