3,2,0,8,7,4,6,0,3
6,10,0,8,2,7,10,5,9
4,2,0,6,8,1,5,1,4
5,3,7,4,9,6,9,10,9
11,5,8,1,3,2,1,10,7
