3,5,0,0,0
2,4,3,5,0
4,2,4,1,4
2,6,1,1,2
5,3,3,5,1
