0,0,0,0,6,0
0,0,0,0,4,0
0,0,0,0,2,0
4,0,1,1,5,0
3,2,5,7,3,6
