0,0,0,0,0
0,0,0,0,0
0,0,3,0,4
5,0,3,0,5
2,1,1,2,4
