0,0,0,0,0,0,0
0,3,0,0,0,0,2
0,1,2,3,0,0,1
0,3,4,1,0,0,2
0,3,4,4,0,1,2
