0,0,0,0,0
0,0,0,3,0
0,0,0,3,0
4,0,2,2,0
2,1,1,1,3
