3,4,2,0,0,0,8,0
4,3,6,2,9,9,7,1
1,1,6,5,7,7,2,5
7,4,8,6,3,2,9,5
8,9,3,6,5,1,4,8
