0,0,0,0,0,0,0,0,0
0,0,0,0,0,0,0,5,0
0,0,7,0,0,0,6,3,0
5,4,2,0,1,0,1,3,3
4,6,2,5,2,6,7,4,1
