2,0,0,0,1
7,0,4,3,6
7,6,2,5,7
4,5,5,1,1
3,2,3,6,4
