0,0,0,0,0,0,0,0
0,0,0,0,0,0,0,0
0,9,0,0,3,0,0,3
9,2,0,1,4,7,6,5
6,8,4,5,2,7,1,8
