0,0,0,0,0,0,0,0
0,0,0,0,0,0,1,0
0,2,0,0,6,3,1,0
5,2,5,0,6,1,4,0
4,3,4,0,6,3,2,5
