0,0,0,0,0,0
0,0,0,0,0,0
2,0,0,3,0,2
4,0,1,4,0,3
5,2,3,1,4,1
