0,0,0,0,0,0
0,0,0,0,0,0
6,3,0,0,0,0
1,3,5,0,4,6
7,4,1,5,2,2
