0,0,0,0,0
0,0,0,0,0
0,0,0,0,1
3,0,1,2,2
1,3,2,3,4
