0,0,0,0,0,0,0,0
0,0,0,0,0,0,0,0
0,2,1,0,0,0,5,6
0,5,3,5,3,4,6,1
0,2,4,3,2,4,1,6
