12,1,7,0,18,14,2,0
11,3,10,0,4,6,5,0
10,16,18,1,15,2,9,15
3,11,4,17,13,6,16,14
12,8,8,13,9,17,7,5
