0,0,0,0,0,0,0
2,0,0,0,0,0,1
3,0,0,0,0,0,4
3,0,0,1,2,0,3
4,4,1,2,1,3,2
