0,0,0,3,2,0,4,6
7,1,4,9,8,6,7,4
1,9,9,5,6,7,1,2
9,2,8,1,3,5,6,5
8,3,4,7,3,2,8,5
