0,0,0,0,0,0,0,0,0
0,0,0,0,0,0,0,1,2
0,5,0,0,0,2,0,3,1
3,4,0,0,0,4,3,5,1
4,5,4,0,2,3,2,5,1
