0,0,0,0,0,0,0
4,0,0,0,0,0,0
1,0,5,0,0,0,4
2,0,2,0,3,3,3
5,0,1,4,1,2,5
