0,0,6,2,0,8,8
0,4,4,5,3,1,6
5,7,2,4,7,3,3
6,8,7,1,3,6,1
7,4,5,5,2,2,1
