0,0,0,0,0,0
0,0,0,0,0,3
3,0,0,0,0,4
1,5,1,0,0,4
2,4,1,2,3,2
