0,0,0,0,0,0,0,0,0
0,5,0,0,0,1,0,0,0
7,2,0,6,0,1,0,0,5
6,3,0,3,0,2,0,4,7
4,1,4,2,0,5,0,6,3
