1,4,0,8,5,1,0,12
6,10,0,4,8,11,7,9
6,7,0,11,2,3,12,9
11,5,10,3,8,3,5,6
10,2,7,2,12,9,1,4
