3,0,0,5,0
6,3,4,2,0
1,1,3,5,4
1,4,4,3,2
5,2,5,2,1
