0,0,0,0,0,0
0,0,0,0,0,0
0,5,0,0,3,2
6,1,0,0,5,7
1,3,4,4,2,6
