9,3,14,0,6,0,7,0,0
13,2,1,1,10,14,3,6,8
8,6,7,12,5,5,13,11,5
10,7,2,9,9,12,1,3,11
11,4,4,2,10,12,13,8,4
