0,0,0,0,0,0,0,0
0,0,0,5,0,0,0,0
1,5,0,6,0,0,0,3
4,4,3,4,0,0,0,6
2,2,1,3,6,2,1,5
