14,8,0,0,17,9,2,0,18
9,15,12,11,13,2,5,0,1
16,20,8,1,3,4,15,7,17
12,19,4,6,5,21,18,14,20
19,16,7,13,10,10,3,6,11
