0,0,0,0,0,0
0,0,0,4,0,3
0,0,0,3,0,2
2,0,5,5,0,1
7,6,6,1,0,4
