0,0,0,0,0,0
5,0,0,0,0,0
4,3,1,0,0,0
1,2,2,0,4,0
1,4,3,0,2,3
