0,0,7,0,5,6,0
1,2,7,5,1,4,5
2,8,4,3,1,8,7
2,7,8,3,4,5,6
2,6,6,3,4,3,1
