0,0,0,0,0,0,0,0,0
0,0,0,4,0,0,0,0,0
0,7,0,4,0,0,0,0,6
1,2,0,9,10,3,9,7,10
6,2,0,8,3,1,5,8,5
