0,0,0,0,0,0,0
0,0,0,0,0,0,0
0,0,7,5,0,1,0
3,0,6,5,4,6,3
4,0,8,7,2,1,2
