0,0,0,0,0,0,0
0,0,2,0,0,0,0
0,0,2,0,5,0,3
1,0,5,0,3,7,6
8,4,1,0,7,4,6
