0,0,0,0,0,0
0,0,0,0,0,0
2,0,0,0,0,0
3,2,1,3,1,3
1,1,2,2,4,3
