0,0,0,0,0,0,0,0,0
0,0,0,0,0,0,0,0,0
0,5,0,0,0,0,0,6,2
0,6,4,6,1,4,1,7,5
3,7,3,5,2,4,1,3,2
