0,5,2,8,8,0,0
6,1,6,3,2,0,1
2,3,7,5,7,4,4
6,1,5,2,1,4,3
5,6,4,7,3,8,7
