0,0,0,0,0
0,0,0,0,0
0,3,0,0,0
2,2,2,1,0
3,4,1,3,1
