11,0,2,0,0,0,5,6
2,3,11,2,4,10,4,9
5,12,4,11,3,12,8,1
12,6,7,7,9,1,9,8
6,8,3,1,10,10,7,5
