0,0,0,0,0,0,0,0,0
0,0,0,3,0,0,0,0,0
0,0,4,2,0,3,0,2,4
0,0,1,1,0,3,5,2,1
0,2,5,5,5,3,4,4,1
