3,5,1,2,0,0,0
8,6,5,1,0,7,5
1,6,4,7,6,4,7
4,3,7,5,2,3,1
4,8,3,2,8,2,6
