5,0,2,0,10,9,12,0,0
8,8,11,4,9,5,14,5,2
3,8,1,7,4,14,12,2,11
3,3,6,9,7,10,1,13,13
11,10,4,12,7,13,6,1,6
