16,0,0,18,9,20,0,19,14
12,9,0,3,1,14,4,19,16
10,11,8,6,21,18,7,7,2
8,15,1,5,12,13,5,4,6
2,20,3,13,11,17,10,17,15
