0,0,0,0,0,0,0,0
5,0,0,0,0,0,0,4
4,0,0,0,0,3,0,3
2,1,4,3,0,1,0,2
1,5,1,2,4,3,0,2
