0,1,0,6,15,19,9,11,0
20,4,17,9,4,12,16,17,0
6,11,18,15,19,7,10,12,20
2,10,16,14,21,2,8,5,13
14,5,18,1,13,7,8,3,3
