0,0,0,0,0,0,0,0,0
0,0,0,1,0,0,0,0,7
0,4,0,6,0,0,0,0,2
5,6,4,3,0,1,0,0,2
5,7,3,5,4,3,2,6,1
