0,0,0,0,0,0
0,0,0,0,0,2
2,0,0,0,0,1
4,0,6,6,0,3
4,5,1,5,7,3
