1,0,5,0,0,7,0
3,8,2,7,5,2,6
1,4,5,4,7,7,4
3,8,2,5,6,1,4
8,1,6,2,3,3,6
