5,9,0,9,5,0,0,2,0
9,3,1,8,3,10,2,10,8
3,8,6,3,4,1,2,11,4
7,6,5,6,4,6,7,9,1
1,7,7,10,2,8,5,4,10
