14,1,0,0,1,2,0,0
15,5,15,12,17,3,8,7
16,4,16,10,7,4,9,6
10,13,8,11,11,2,3,13
18,12,5,14,9,18,17,6
