0,11,3,0,0,6,8,4,12
0,3,4,6,4,12,14,5,1
9,7,1,13,2,13,10,1,7
5,9,10,5,12,11,10,14,8
13,3,7,9,8,2,6,11,2
