0,0,6,0,7,2
0,2,1,3,4,5
1,6,3,7,5,4
1,6,6,2,3,4
4,3,2,5,1,5
