0,0,0,0,0,0,0
0,0,0,0,0,0,1
0,0,0,0,0,0,1
3,0,4,1,3,2,2
1,3,2,3,2,4,4
