0,0,0,0,0,0,0,0,0
0,0,0,0,0,0,0,1,0
7,0,0,0,0,0,0,6,0
3,6,0,9,5,8,7,3,1
2,10,5,4,8,9,4,2,10
