0,0,2,0,3,0,4,6
9,1,5,7,9,2,3,1
2,6,5,9,1,2,7,4
8,7,4,8,8,6,1,3
6,9,5,7,5,3,8,4
