0,0,0,0,0,0
0,0,0,0,0,0
0,5,0,0,0,4
6,3,0,1,6,2
2,1,5,3,4,7
