0,0,1,0,0,5
9,1,2,7,6,6
6,7,5,8,4,4
8,9,3,1,4,2
3,2,5,8,7,3
