8,0,12,0,0,9,3,0
5,5,2,8,10,7,4,9
6,7,10,1,12,1,11,3
1,11,8,2,6,2,11,9
7,6,12,5,3,4,10,4
