8,0,0,3,6,0,2,5
6,0,8,7,9,9,6,7
8,9,5,4,8,6,1,4
5,5,4,3,7,3,9,3
2,2,1,1,2,1,7,4
