0,0,7,0,12,7,7,0
2,10,11,11,12,11,5,10
1,10,5,9,6,9,2,8
8,3,3,1,3,12,4,5
8,1,6,4,2,6,4,9
