0,0,0,0,0,0,0
0,4,0,0,0,0,0
0,1,2,0,4,0,0
0,3,3,0,2,2,1
3,1,4,0,3,1,2
