0,0,0,0,0,0,0,0
0,0,0,0,0,0,0,0
0,9,5,0,1,3,7,0
0,1,8,6,4,3,2,0
0,4,2,9,7,6,5,8
