0,0,0,7,1,6,2
0,4,5,1,8,7,7
3,5,8,4,2,6,3
3,5,5,6,3,1,7
6,4,4,8,2,2,1
