7,0,9,1,5,9,0,0
4,11,12,2,7,11,9,0
7,2,4,8,3,10,12,8
12,8,5,2,6,1,6,10
10,5,11,3,4,6,1,3
