0,0,0,0,0,0,0,0,0
7,2,0,0,0,0,0,0,0
1,5,5,0,0,0,4,0,4
1,3,6,0,0,0,7,0,5
3,6,4,2,0,3,2,6,1
