9,5,0,0,8,0,8,1
6,1,0,4,1,8,4,2
7,9,1,7,2,2,3,9
7,3,2,7,3,9,8,6
5,6,5,3,6,4,4,5
