0,3,3,0,0,4
0,2,5,6,6,6
1,7,5,3,2,2
1,1,4,6,5,4
4,5,7,2,3,1
