0,0,0,0,0,0,0
0,1,0,1,0,0,0
0,3,0,1,0,0,0
3,2,2,2,0,4,0
3,3,1,4,2,4,0
