0,0,0,0,0,0,0,0
0,0,0,0,8,0,0,0
0,0,0,0,7,0,0,2
2,3,6,0,3,5,1,9
4,6,4,7,1,9,5,8
