0,0,0,0,2,0
0,0,0,0,2,0
0,0,0,0,3,0
0,4,0,4,2,4
3,1,3,1,5,1
