7,0,0,4,0,7,11,10
11,7,0,1,9,11,6,12
8,1,8,6,4,12,12,6
4,5,5,5,9,10,3,1
2,2,10,3,3,9,2,8
