0,0,0,0,0,0,0
0,0,0,0,0,0,0
0,3,2,4,3,0,0
0,3,4,4,1,0,0
2,1,1,1,2,2,3
