0,0,3,0,0
2,1,3,5,1
4,1,7,7,2
2,4,5,7,6
6,3,5,4,6
