0,4,18,0,16,8,5,0,15
0,12,10,17,13,2,7,2,3
13,16,15,12,19,1,10,14,20
6,1,8,9,11,7,4,14,18
6,3,5,9,11,21,20,17,19
