0,0,0,0,0,0
0,0,0,0,0,0
0,0,0,0,0,2
3,3,2,4,1,1
1,5,2,4,3,4
