0,0,0,0,0,0,0,0
0,0,2,0,0,0,0,0
4,0,1,0,0,2,0,2
6,6,1,0,0,3,0,3
4,3,5,4,5,1,6,5
