8,0,0,9,5,0,11,7
11,6,0,4,3,2,12,11
6,7,8,2,2,4,4,10
5,1,3,1,12,1,10,9
3,8,7,10,12,9,5,6
