0,0,0,0,0,0
0,0,0,0,0,0
0,0,0,3,3,2
0,2,0,5,1,4
2,1,1,4,3,4
