8,2,6,4,0,0,0
8,4,6,1,3,0,4
5,1,2,2,3,7,1
4,7,7,1,3,5,8
7,5,5,6,3,2,6
