0,0,4,8,0,6
0,1,5,4,1,2
2,8,3,5,7,8
9,3,9,4,3,6
5,7,2,6,1,7
