0,0,0,2,0,0,0
0,0,0,4,0,0,0
0,4,0,5,4,0,0
0,5,0,1,5,0,0
3,1,3,3,1,2,2
