0,0,0,0,0,0,0,0
0,0,0,0,0,0,0,0
4,0,0,0,1,0,1,0
1,3,2,3,4,2,1,0
2,5,3,4,4,3,5,2
