0,0,0,0,0,0,0,0
0,0,0,0,0,0,0,0
1,3,1,0,0,0,0,1
5,3,4,0,2,4,0,3
4,1,2,3,2,2,4,5
