0,0,0,0,0,0,0,0
0,0,0,0,0,0,0,0
1,0,1,4,0,3,0,0
9,9,8,5,6,6,2,0
5,3,8,7,2,7,4,0
