0,3,0,6,0,15,17,4
8,18,0,13,14,2,11,15
4,11,18,16,3,12,9,5
8,7,13,7,17,14,9,10
1,12,2,5,16,6,1,10
