0,18,0,0,0,6,1,11
9,16,2,4,3,17,11,10
14,7,12,17,1,12,10,9
14,5,2,16,15,13,13,8
4,3,7,6,15,18,5,8
