0,0,0,0,0,0,0
0,0,8,0,0,0,0
0,2,5,0,0,0,0
1,2,4,3,1,0,0
5,7,3,6,7,6,4
