0,0,0,2,2
0,4,5,1,4
3,2,1,6,3
1,3,1,4,4
3,5,5,5,2
