0,0,0,0,0
0,0,0,0,0
4,0,0,0,0
2,1,3,0,1
3,2,5,4,5
