0,0,0,0,0,0,0
0,0,2,0,0,0,0
0,3,2,0,0,2,0
1,3,3,0,4,4,0
4,1,1,2,3,1,0
