0,0,0,0,0,0
0,0,0,0,0,0
4,0,1,0,0,3
2,4,3,2,0,4
2,5,3,1,0,1
