0,0,0,0,0,0,0
0,4,0,0,0,0,0
0,7,0,0,0,0,3
6,3,0,7,0,1,2
4,5,1,8,2,6,5
