2,7,6,1,2,0,0,0,2
9,8,6,8,10,0,4,3,10
4,1,1,2,9,4,5,3,9
6,7,8,7,9,10,5,1,3
3,10,6,5,5,7,11,4,8
