7,0,4,0,0,0,3,9
5,7,3,6,7,4,6,5
6,9,1,5,1,6,2,2
9,3,3,5,1,2,8,8
4,8,7,1,2,4,9,8
