0,0,6,4,1
0,0,2,2,3
1,4,5,1,4
5,5,3,2,4
3,5,1,2,3
