0,0,0,0,0,0,0
0,0,0,0,5,0,0
2,0,0,0,1,0,0
1,2,4,1,4,0,0
5,3,3,4,5,2,3
