0,2,0,10,11,9,7,0
11,6,0,7,8,3,5,8
5,4,3,10,12,6,1,7
2,8,9,1,2,4,10,4
5,9,11,3,12,1,12,6
