0,0,0,0,0,0,0
0,0,0,0,0,0,0
0,0,0,0,2,0,0
2,4,3,1,5,5,2
1,5,1,3,3,4,4
