2,0,7,0,0
1,3,1,0,2
5,3,5,5,7
4,4,7,6,6
3,6,4,1,2
