0,0,0,0,0,0,0,0,0
0,0,0,0,0,0,0,0,0
3,0,0,2,0,0,0,4,5
3,0,0,6,2,5,7,4,7
6,1,5,1,4,6,1,2,3
