0,0,0,0,0,0,0,0,0
0,0,0,0,2,0,6,0,0
9,0,0,0,8,0,9,0,0
5,0,0,10,4,0,5,8,1
4,7,3,7,1,6,10,2,3
