5,7,3,0,0,0
5,4,6,6,7,0
3,6,4,4,1,2
2,1,3,4,1,2
6,5,3,5,1,2
