0,0,0,0,0
0,0,0,0,0
1,0,0,0,0
4,3,5,2,0
3,1,2,5,4
