3,0,0,0,0,4
1,1,5,1,2,2
6,2,1,2,7,4
4,6,5,5,4,3
7,3,3,5,6,6
