0,0,0,0,0,0,0,0
0,0,0,6,0,0,0,0
0,1,0,2,0,0,0,0
0,6,5,1,4,3,1,6
4,3,5,5,2,3,4,2
