0,0,17,0,1,0,11,16,18
16,6,10,12,14,19,12,17,21
9,11,15,15,8,2,19,4,10
6,8,7,7,3,13,5,20,3
4,9,20,14,5,2,18,1,13
