0,2,6,8,0,0
0,3,9,3,6,7
5,6,2,9,1,4
1,7,8,8,2,4
4,5,5,1,7,3
