0,0,0,0,0,0,0,0,0
2,0,0,0,0,1,0,0,0
2,0,0,0,0,3,0,5,0
3,3,4,0,0,4,2,4,0
2,1,5,5,1,5,4,1,3
