0,0,0,0,0,0,0,0,0
0,0,0,0,0,0,0,0,4
0,3,0,0,0,7,0,0,4
0,5,2,5,2,7,6,0,3
3,6,1,1,1,2,4,6,5
