0,0,0,5,8,7,0
7,4,2,5,3,2,3
5,4,5,3,6,1,7
7,1,2,2,6,6,4
8,4,8,6,1,3,1
