8,7,9,0,0,0,21,0,18
11,1,5,6,15,11,12,14,13
4,19,6,16,7,12,17,14,20
20,10,1,5,13,3,8,15,19
18,10,17,16,4,9,2,2,3
