0,0,0,0,0,0
0,0,0,0,0,0
0,0,4,0,1,0
1,3,2,0,5,4
1,2,2,3,4,3
