0,0,0,0,0
0,1,0,0,0
3,1,0,0,0
1,4,3,0,0
2,2,2,0,3
