0,3,0,5,3,1,0,7,2
0,7,8,5,10,2,4,8,10
8,6,9,10,2,9,11,10,1
5,1,6,7,1,9,3,4,9
6,4,2,3,8,7,4,5,6
