0,0,0,0,0
0,0,0,0,0
0,0,1,0,0
2,3,1,1,0
2,2,3,1,2
