0,0,0,0,0,0
0,0,2,0,0,0
0,3,1,0,0,0
0,3,1,1,3,0
3,4,2,2,1,2
