0,0,0,0,0,0,0,0
3,0,0,0,0,0,0,0
6,4,0,0,1,0,0,5
3,5,0,2,1,0,4,2
1,3,0,5,2,6,6,4
