0,1,0,0,0
7,2,6,1,3
3,5,6,5,7
4,6,5,3,7
2,2,4,4,1
