0,0,0,0,0,0,0,0
0,0,0,0,0,0,0,5
1,0,0,0,3,0,0,2
2,0,6,4,5,1,0,2
4,5,3,4,6,6,1,3
