0,0,0,0,0,0,0,0
0,0,0,0,0,0,0,0
0,0,4,0,0,1,3,1
4,0,2,0,1,3,3,1
4,4,2,5,5,2,3,2
