0,9,5,0,6,0,8,10,0
4,9,2,7,6,6,1,4,10
3,9,3,3,1,3,7,1,5
2,11,2,5,10,1,8,9,8
6,5,4,8,7,2,10,7,4
