5,0,2,6,0,5
8,0,7,8,0,6
9,1,4,5,8,3
1,4,4,3,7,1
2,9,6,7,2,3
