0,0,0,0,0,0,0
0,0,0,0,0,0,0
0,0,0,0,4,0,2
3,0,4,3,4,3,2
1,1,3,1,2,1,2
