2,10,0,0,9,4,8,0,0
11,1,4,1,12,6,2,6,12
5,3,7,2,10,9,3,6,4
12,13,5,5,9,14,11,13,11
7,1,10,8,7,14,8,3,13
