5,0,0,7,0,4,0
3,1,5,1,4,2,2
3,7,5,2,7,1,5
2,6,8,3,8,4,7
3,4,6,1,8,6,6
