0,4,0,5,3
0,5,3,5,5
0,2,1,1,2
4,1,2,3,1
3,4,2,6,4
