0,0,0,0,0,0,0,0,0
4,0,0,0,0,2,0,0,0
3,0,0,0,1,3,0,0,0
5,3,2,5,5,4,0,0,1
4,5,3,2,1,1,2,0,4
