0,6,0,3,0
0,1,6,4,3
2,5,6,2,5
1,7,2,7,4
7,1,5,4,3
