7,4,0,6,0,5,4,2
10,3,0,10,0,6,12,10
2,2,1,9,8,6,12,11
8,9,12,11,3,9,5,7
5,8,7,1,1,4,11,3
