0,7,12,5,3,0,0,8
6,7,2,12,12,6,0,5
9,2,11,9,10,4,3,10
1,9,2,4,11,5,4,6
3,8,7,11,8,1,10,1
