0,0,0,0,0,0,0,0
0,0,0,0,0,0,0,0
0,0,6,0,0,4,3,1
0,0,9,4,2,3,5,7
9,7,1,8,6,5,8,2
