0,3,6,0,0,5,16,0
4,2,13,8,12,8,12,18
11,7,6,10,13,14,15,17
16,5,10,7,14,3,9,1
9,4,2,1,17,11,18,15
