0,0,0,0,0,0,0
0,0,0,3,0,0,0
0,0,0,2,0,0,5
5,1,0,1,1,0,2
3,4,4,4,5,2,3
