0,0,0,0,0,0,0,0,0
0,0,0,0,0,0,0,0,0
3,1,0,6,0,0,4,0,0
6,5,0,2,3,7,2,0,1
6,2,5,1,5,7,4,3,4
