0,5,0,3,2,0,0
8,6,1,5,5,4,6
1,7,1,3,6,3,7
2,5,7,4,2,6,8
1,2,8,7,3,4,4
