0,3,2,8,0,0,14,0,13
2,9,1,6,11,9,5,3,12
4,3,5,1,12,14,5,9,7
2,12,4,6,11,8,13,7,10
4,10,6,8,11,10,13,1,7
