0,0,0,0,0
1,0,0,0,0
1,0,0,0,0
2,0,0,3,4
3,1,3,2,2
