0,0,0,0,0,0,0,0
0,0,1,0,0,0,0,0
0,0,6,5,0,2,0,0
3,0,9,8,7,1,8,0
4,5,3,2,9,4,6,7
