7,7,0,0,0,0
1,4,7,9,3,2
8,8,4,1,9,3
5,5,4,2,8,6
6,1,5,3,6,2
