0,0,7,7,0
4,0,4,2,5
1,4,1,6,3
1,5,3,6,6
2,5,2,7,3
