0,0,0,0,0,0
0,0,0,3,0,0
0,0,0,5,0,0
4,2,3,2,0,1
3,1,2,4,1,4
