0,0,0,0,0,0,0,0,0
0,0,0,0,0,0,0,0,0
0,1,0,0,3,2,0,5,8
9,10,0,0,6,3,0,10,4
1,5,7,8,2,4,6,7,9
