0,6,9,11,7,13,0,0,2
3,5,10,14,7,3,0,12,2
8,10,5,9,1,11,4,1,8
2,3,10,7,8,4,6,4,1
9,12,12,14,5,13,6,11,13
