0,0,0,0,0,0
0,0,0,0,0,0
0,2,1,0,3,0
1,3,1,0,1,0
2,2,2,4,3,3
