9,0,6,1,6,5,0,0,8
7,3,4,6,7,8,5,0,1
2,2,3,10,3,9,7,1,8
11,7,8,10,2,4,10,4,5
10,5,1,2,4,3,9,6,9
