0,0,0,0,0,0
0,0,0,0,0,0
0,0,2,1,5,0
0,0,6,5,6,7
3,3,4,1,2,4
