0,0,0,0,4,0,0,0,0
0,1,0,0,3,0,0,0,0
0,1,0,0,4,0,0,0,0
0,2,5,3,2,1,1,0,0
3,5,5,5,3,2,4,2,4
