0,0,0,4,0,1,10,4
11,6,12,11,10,2,11,5
6,7,8,9,5,1,8,7
5,2,12,3,1,9,3,10
6,12,9,3,4,7,2,8
