0,0,0,0,0,0,0
0,0,0,0,0,0,0
2,0,5,7,0,0,7
6,0,1,2,0,0,3
6,4,5,4,3,1,8
