0,0,0,0,0,0
0,0,0,0,0,0
0,2,0,6,0,0
0,4,1,7,5,6
2,4,3,3,1,5
