10,0,0,0,2,5,6,0
3,9,6,11,12,12,7,11
9,11,10,2,1,1,8,2
12,1,3,4,5,5,6,8
4,7,7,4,10,9,8,3
