14,0,7,0,0,0,1,7,6
10,2,3,6,2,1,10,1,12
4,13,2,4,5,3,9,10,4
3,9,14,8,12,7,5,9,11
11,13,13,6,11,12,8,8,5
