0,0,0,0,0,0,0,0
0,0,0,0,0,0,0,0
3,0,0,0,0,0,5,4
4,3,4,0,2,6,2,5
6,6,3,1,5,1,2,1
