1,4,4,0,0
7,1,5,4,0
6,2,3,3,0
7,5,5,1,7
6,2,2,6,3
