0,0,0,0,0,0,0,0,0
0,0,0,0,0,0,0,0,0
3,5,0,0,0,0,4,0,0
2,1,4,5,2,0,2,3,3
5,3,4,2,1,5,1,1,4
