0,3,2,4,0,1,0
8,7,6,7,0,1,8
3,7,4,6,1,1,4
6,5,2,6,2,8,5
5,3,3,2,4,7,5
