0,0,0,0,0,0
5,0,0,0,0,0
4,0,0,0,3,0
2,3,3,0,4,0
1,4,2,1,1,2
