14,0,19,0,1,0,20,4,0
21,7,2,16,3,17,5,14,8
6,3,11,12,5,11,18,8,10
16,10,1,17,13,12,15,4,9
13,9,18,7,15,2,20,19,6
