0,0,0,0,0,0,0
0,0,0,0,0,0,0
0,2,6,0,0,0,0
3,4,7,8,0,5,2
1,5,4,6,7,3,1
