0,0,0,4,5,5
8,0,8,1,7,6
2,4,8,7,3,6
1,4,7,6,2,3
1,5,2,3,9,9
