0,0,0,0,0,0,0,0,0
0,0,0,0,0,0,0,0,0
2,0,0,0,0,5,4,0,0
5,2,6,0,3,5,4,1,3
6,3,1,4,1,7,7,2,6
