0,3,0,3,0,0
8,2,2,4,6,6
6,1,8,7,3,4
5,5,9,8,7,9
4,2,1,5,7,1
