0,0,0,0,0,0
0,0,0,0,0,0
0,0,0,2,2,2
0,0,5,4,1,4
1,4,3,3,3,1
