0,0,0,0,0
0,0,0,0,0
2,0,0,0,0
1,3,3,0,1
1,2,2,1,2
