0,0,0,0,0
0,0,0,0,0
0,2,3,4,0
0,1,2,3,0
3,1,2,1,0
