0,0,0,0,0,0
0,0,0,0,0,0
0,4,0,0,0,2
3,1,2,2,0,3
1,1,2,1,3,3
