0,0,0,0,0,0,0,0,0
0,0,0,10,0,0,0,0,0
0,0,4,3,0,10,0,0,0
2,6,1,2,0,3,0,4,1
7,9,8,7,5,8,5,9,6
