0,3,0,1,0
0,5,2,2,4
2,4,1,4,5
2,4,3,3,5
1,6,3,5,1
