0,0,0,0,0,0
0,0,0,0,0,0
0,7,3,6,0,0
0,6,2,1,0,4
5,2,3,4,5,1
