0,0,4,0,3
0,3,1,7,6
4,6,5,6,7
1,2,5,4,3
2,2,1,7,5
