0,0,0,0,0
0,0,0,0,0
0,0,3,1,0
1,0,4,3,2
2,0,3,1,2
