0,0,0,0,0,0,0,0
6,0,0,0,0,0,1,0
4,0,0,0,0,0,5,0
1,4,0,0,2,2,1,5
4,3,3,6,5,6,3,2
