0,0,0,0,0,0,0,0,0
0,0,5,0,0,0,0,0,0
0,8,1,0,0,0,1,0,0
2,6,4,5,0,0,9,9,4
10,8,10,7,7,2,3,6,3
