0,0,0,0,0,0,0
0,0,0,0,3,0,0
0,4,0,0,2,3,0
1,5,5,0,2,1,0
2,1,5,0,4,3,4
