0,0,0,0,0,0,0,0
0,2,0,0,0,0,0,0
5,4,0,0,0,0,4,0
3,2,1,1,0,1,4,0
4,5,3,2,2,3,3,1
