0,0,0,8,0,0,0,0,0
0,0,0,6,0,0,0,0,0
0,0,0,2,0,0,3,0,9
0,7,5,5,0,6,1,0,10
4,9,3,2,10,8,7,4,1
