0,4,7,0,8,0,0
7,1,1,4,8,6,5
8,6,5,7,4,5,3
2,5,7,3,6,1,2
3,6,1,4,3,2,2
