0,0,0,0,0
0,0,0,0,2
0,4,0,0,3
1,5,0,0,5
1,3,0,4,2
