0,6,0,7,9,8,0,6,0
8,2,1,6,8,10,3,5,1
5,9,4,7,5,4,2,8,9
10,1,9,2,3,2,1,7,10
6,4,10,5,3,3,4,7,11
