0,0,9,6,0,3,0,1
1,1,8,3,8,4,6,6
6,4,1,7,2,3,7,8
4,4,9,9,5,2,8,2
5,7,5,9,7,3,2,5
