0,0,0,0,0,0,0
3,0,0,0,0,0,0
1,5,0,0,0,0,0
5,5,4,3,0,3,0
4,2,4,2,1,1,2
