0,6,0,0,7,0,4
2,7,6,1,8,2,3
8,4,3,8,4,1,1
2,1,5,7,7,6,2
4,5,5,6,3,5,3
