0,0,0,0,0
0,0,4,0,0
0,0,1,0,0
0,0,1,2,2
5,5,3,4,3
