12,1,6,0,0,4,0,0,3
9,13,4,14,11,8,11,2,1
12,9,10,13,4,6,14,11,13
3,3,8,7,10,5,9,12,8
5,5,2,10,7,2,7,6,1
