0,0,0,0,0,0,0,0
0,0,0,0,0,0,0,0
0,0,4,0,0,1,0,2
3,1,1,2,0,4,2,5
1,2,4,3,3,5,4,3
