0,2,0,0,3
3,4,4,0,3
5,4,5,2,5
2,4,1,1,3
2,1,1,5,6
