0,0,0,0,0,0
0,0,0,0,0,0
0,4,0,0,0,6
0,5,6,4,1,3
2,1,5,2,3,7
