0,0,1,0,5
0,7,6,3,3
2,4,5,6,1
2,4,6,5,7
7,3,2,4,1
