0,0,0,0,0,0,0
0,0,0,0,0,0,0
0,0,4,0,0,1,0
3,1,2,2,2,3,0
3,3,2,4,1,4,1
