0,10,5,8,0,9,16,0
15,14,16,17,0,13,15,7
18,3,10,12,9,11,18,13
5,4,6,11,3,12,8,1
7,6,2,14,17,4,1,2
