0,0,16,1,13,9,0,2
12,17,6,9,1,8,0,4
8,11,10,7,17,5,6,15
18,3,10,11,15,4,7,14
12,5,16,3,18,2,13,14
