0,0,0,0,0,0,0,0,0
4,0,0,0,1,0,0,0,0
3,0,3,0,2,0,0,0,0
2,7,7,1,5,6,0,2,0
5,1,4,4,3,6,5,6,0
