4,4,3,0,0
5,4,2,0,3
1,2,1,0,5
3,1,2,4,2
5,6,1,3,5
