5,0,11,0,10,0,1,2,1
2,0,8,4,6,2,4,4,1
10,3,3,7,3,6,8,2,7
5,10,9,5,7,8,5,1,8
6,3,4,7,9,6,9,9,10
