0,0,6,8,4,7,0
0,6,2,1,5,7,8
1,4,3,7,2,4,2
2,4,1,8,3,1,5
6,5,3,7,3,6,5
