0,0,0,0,0,0,0,0
0,0,0,0,0,0,0,0
0,0,1,0,6,5,2,0
2,1,4,0,5,4,6,0
3,1,6,2,3,3,4,5
