0,4,6,13,0,11,13,10,0
7,1,2,3,8,12,3,2,0
9,14,5,7,11,12,5,14,5
9,8,9,8,4,10,6,1,10
3,13,1,11,6,7,12,4,2
