0,0,0,0,0
0,0,0,0,1
0,0,0,0,4
0,2,1,3,3
0,2,2,3,1
