0,13,0,0,18,20,8,0,14
6,16,2,3,20,3,7,10,15
14,17,2,12,9,6,19,1,10
13,1,11,4,18,11,15,16,5
9,7,19,5,17,4,21,8,12
