0,7,5,0,0,2,2,0,6
9,3,2,8,11,1,9,7,7
6,3,7,1,9,10,4,4,5
2,6,1,3,4,8,8,5,6
10,3,9,10,4,1,10,8,5
