3,1,0,0,4,9,0,6
11,7,3,0,4,7,4,8
2,6,10,10,5,12,5,8
5,11,3,8,1,9,11,9
2,10,6,2,12,7,1,12
