0,0,0,0,0,0
0,0,0,0,0,3
0,0,0,3,0,2
0,0,3,3,2,1
2,4,1,2,1,1
