0,10,6,0,8,1,0,8
12,10,5,9,4,8,0,11
11,4,11,10,2,7,4,12
6,5,7,1,2,7,12,9
6,5,2,3,3,1,3,9
