0,0,2,5,4
0,0,2,3,5
5,1,3,4,3
4,1,3,6,1
2,2,5,1,4
