0,0,0,0,0,0,0,0
0,0,0,0,0,1,0,0
0,0,0,6,1,6,4,4
0,0,0,5,5,2,5,6
0,2,2,3,3,1,4,3
