11,0,7,0,0,7,11,8
1,0,13,6,9,5,1,17
3,10,14,8,13,10,16,4
18,12,3,15,18,16,9,2
2,17,15,14,5,12,4,6
