12,9,6,0,9,0,0,0
12,7,10,11,2,11,4,5
8,3,1,7,5,3,2,8
8,6,11,6,12,10,1,4
5,1,7,2,4,3,9,10
