9,3,3,0,6,0,0,9
5,8,1,0,2,4,5,1
8,8,7,4,1,3,9,5
2,1,8,5,7,7,2,4
7,6,9,3,6,2,6,4
