0,0,0,0,0,0
0,0,0,0,0,0
0,0,1,5,0,4
6,0,3,4,0,1
3,6,7,2,2,5
