5,0,11,0,0,4,0,9,5
12,10,7,1,14,8,7,11,2
11,10,10,8,6,9,4,9,1
6,12,8,13,12,3,13,3,6
13,2,7,1,2,3,14,5,4
