0,0,0,0,0,0,0
0,0,0,0,0,0,0
3,0,0,2,5,0,0
1,2,0,4,7,0,5
1,3,6,6,7,4,8
