20,3,1,6,0,0,0,0,6
12,7,17,9,17,13,8,18,15
19,11,16,10,14,1,12,11,13
18,10,7,9,2,2,4,5,4
19,21,5,15,8,20,16,14,3
