0,0,0,1,0,0,0
0,0,6,6,0,0,0
0,0,7,5,0,0,0
5,0,8,7,3,0,0
2,4,1,2,4,3,0
