0,5,0,0,0
1,3,4,4,3
4,1,5,6,2
7,2,6,3,7
7,2,5,1,6
