0,0,0,0,0,0,0,0,0
0,0,0,0,0,0,0,0,0
0,4,0,0,0,0,5,2,2
0,3,5,2,1,0,1,5,1
5,4,2,3,4,3,4,1,3
