0,0,0,0,0,0,0,0
0,0,3,0,0,0,0,5
0,0,4,3,0,0,6,2
0,0,1,6,0,1,2,4
1,0,4,5,3,2,6,5
