0,0,0,0,0,0,0
0,0,0,0,0,0,0
0,0,3,0,2,4,0
0,0,3,2,2,1,4
3,4,2,1,3,1,1
