0,2,6,0,5,4,0
0,7,4,1,5,4,5
6,7,3,7,3,6,8
2,1,7,2,2,3,1
6,5,3,1,8,4,8
