2,0,9,0,4,7
8,0,4,2,5,9
2,0,4,5,5,3
7,8,6,1,8,6
3,7,6,1,1,3
