0,0,6,0,5,7,8
0,8,3,2,6,4,1
2,6,1,3,4,5,3
7,8,5,4,4,7,2
5,3,1,7,1,2,6
