0,0,6,0,9,3
2,4,2,0,6,6
2,1,9,7,1,3
8,8,4,1,4,7
5,8,7,3,5,5
