0,7,0,5,6,2,1,0,0
10,9,3,1,4,3,9,8,3
2,5,9,4,11,2,2,7,8
6,10,7,1,10,4,1,3,6
5,7,8,9,4,5,6,10,8
