0,0,0,0,0,0,0,0,0
0,0,0,0,0,0,0,0,0
0,7,2,8,0,10,9,0,8
0,1,3,10,0,6,1,0,5
2,6,9,4,7,4,5,0,3
