0,7,0,0,5,0
3,6,7,2,3,2
5,6,3,3,4,4
5,1,6,1,1,2
2,1,4,6,5,4
