0,0,0,0,0,0,0,0,0
0,0,0,0,0,0,0,0,0
5,0,0,3,3,0,0,0,1
1,4,1,5,4,2,5,0,1
4,2,4,3,2,5,3,0,2
